R"MAP(
################
#..............#
#.AA...>....C..#
#.A....B....C..#
#.A..##B##..C..#
#.A..D...EEE...#
#.A..#...E.....#
#....#...E..FF.#
#.GGG#...E..F..#
#.G..@...E..F..#
#.G...HHHH..F..#
#.G...H..H.....#
#.....H..H..II.#
#.@...HHHH..I@.#
#......#.......#
################
)MAP"
