R"MAP(
################
#.............g#
#.AA...>....C..#
#.A....B....C..#
#.A..##B##..C..#
#.A..2...EEE...#
#.A..#...E.....#
#.&..#...E..FF.#
#.GGG#...E..F..#
#.G..@...E..F..#
#.G..aHHHH..F..#
#DG...H..H...a.#
#.....H..H..II.#
#.@...HHHH..I@.#
#.....h#.......#
################
)MAP"
